0000000000000000000000000000000000000000
0000000000000000000000000000000000000000
0000000000003333333333333333333333333333
0000000000000000000000000000000000000000
0000000000000000000000000000000000000000
3333333330000000000000000000000000000000
0000000000000000000000000000000000000000
0000000000000000000000000000000000000000
0000000000000003333333333333000000000000
0000000000000000000000000000000000000000
0000000000000000000000000000000000000000
0000000000000000000000000000000333333333
0000000000000000000000000000000000000000
0000000000000000000000000000300000000000
0000000000000000000000000000000000000000
0000000000000000000000000000000000000000
0000000000000000000000000033333000000000
0000000000000000000000000000000000000000
0000000000000000000000000000000000000000
0000000000000000000000000000000000000000
0000000000000000000000000000003333333333
0000000000000003333333333000000000000000
0000000000000000000000000000000000000000
0000000000000000000000000000000000000000
3333333330000000000000000000000000000000
0000000000000000000000000000000000000000
0000000000000000000000000000000000000000
2222222222222222222222222222222222222222
1111111111111111111111111111111111111111
1111111111111111111111111111111111111111