1110111111111111111111111111111111111111
1010100000000101000111111111111111000001
1010100000000101001000000000000000100001
1010111111111101010011111110111110010001
1010000000001101010100000010100001010001
1011111111101101010100000010100001010001
1000000000101100110100000010100001010001
1000000000101010000100000010100001010001
1000000000101001110100000010100001011101
1000011111101000010100000010100001000101
1111110000001000010100000010100001110101
1000110111110000010100000010111111110101
1110110100000011110111111110100000010101
1010110100000100000100000000111111110101
1010110111111101111111111111100000010101
1010110000000001000000000000000000010101
1010111111111111000000000001111111100101
1010111111111111100000000010000000000101
1010111000000000100000000100111111111101
1010111011111110100000000101000000011111
1010111010000010111111111101000000010001
1010000010000010000000000001000000010101
1011111010000011111110111111000000010101
1000001010000000000010100000000000010101
1000001010000000000010100000000000010101
1111111011111111111110111111111111110111
1000000000000000000000000000000000000001
1111111111111100011111111110001111111111
1000000000000000000000000000000000000001
1111111111111111111111111111111111111111