1111111111111111111111111111111111111111
1111111111111111111111111111111111111111
2222222222222222221222221222222222222222
2222222222222222221222221222222222222222
2222222222222222221111111222222222222222
2222222222222222222221222222222222222222
2222222222222222222221222222222222222222
2222222222222222222111122222222222222222
2222222222222222211121112222222222222222
2222222222222221112222111222222222222222
2222222222222111222222211122222222222222
2222222222221122222222221112222222222222
2222222222221122222222222111222222222222
2222222222222112222222222211122222222222
2222222222222211122222222111122222222222
2222222222222222111122222112222222222222
2222222222222222222122221122222222222222
2222222222222222222122211111122222222222
2222222222222211111122111222122222222222
2222222222222112211111112222122222222222
2222222222221122222211122222112222222222
2222222222221222222222122222211222222222
2222222222221222222221122222221112222222
2222222222211222222211222222222211222222
2222222221112222222111222222222211222222
2222222111222222221122222222222211222222
2222221122222222222111222222222211222222
2222221222222222222211122222222211122222
1111111111111111111111111111111111111111
1111111111111111111111111111111111111111