0000000000000000000000000000000000000000
0000000000000000000000000000000000000000
0000000000000000000000000000000000000000
0000000000000002222222222000000000000000
0000000000000000000000000000000000000000
0000000000000000000000000000000000000000
2200000000000000000000000000000000000022
0000000000000000000000000000000000000000
0000000000000000000000000000000000000000
0000000000000022222222222200000000000000
0000000000000000000000000000000000000000
0000000000000000000000000000000000000000
2220000000000000000000000000000000000222
0000000000000000000000000000000000000000
0000000000000000000000000000000000000000
0000000000002222222222222222000000000000
0000000000000000000000000000000000000000
0000000000000000000000000000000000000000
2222200000000000000000000000000000022222
0000000000000000000000000000000000000000
0000000000000000000000000000000000000000
0000000000222222222222222222220000000000
0000000000000000000000000000000000000000
0000000000000000000000000000000000000000
2222200000000000000000000000000000022222
1111100000000000000000000000000000011111
1111122222222222222222222222222222211111
1111111111111111111111111111111111111111
1111111111111111111111111111111111111111
1111111111111111111111111111111111111111